F 76,76,76
C 99,99,99

NO textures/simonkraft/cobblestone.xpm
SO textures/simonkraft/cobblestone_01.xpm
WE textures/simonkraft/mossy_cobblestone1.xpm
EA textures/simonkraft/cobblestone_02.xpm

111111
100001
100001
100001
100001
100001
111111
      11111111111111111111
      10000000000000000001
      10000000000000000001
      100000000000000000N1
      10000000000000000001
      10000000000000000001
      11111111111111111111
111111
100001
100001
100001
100001
100001
111111

