   WE                            textures/wolfenstein/eagle.xpm
NO      textures/wolfenstein/grey_stone.xpm



SO textures/wolfenstein/red_brick.xpm

F  255, 0, 255

EA textures/wolfenstein/mossy.xpm



C 0,255,255

111111111111111111111111
100000000000000000000001
100N00000000000000000001
100000000000000000000001
111111111111111111111111





111111111111111111111111
100000000000000000000001
100000000000000000000001
100000000000000000000001
111111111111111111111111





