F 25,25,25
C 25,25,25

NO textures/nl_dungeon/new/brickwall.xpm
SO textures/nl_dungeon/new/brickwall.xpm
WE textures/nl_dungeon/new/brickwall.xpm
EA textures/nl_dungeon/new/brickwall.xpm

1111111111111111111
10W1001001001000001
1011000001000001001
1001001000111101111
1001111000001001001
1000000000000001001
1111111111111001001
1011000000000001011
1000000001000000001
1111111111111111111
