F 33,33,33
C 33,33,33

NO textures/nl_dungeon/nl_brickwall.xpm
SO textures/nl_dungeon/nl_brickwall.xpm
WE textures/nl_dungeon/nl_brickwall.xpm
EA textures/nl_dungeon/nl_brickwall.xpm

1211111111111111111
10W1001001001000001
2011000001000001001
1001001001111101111
2001111000001001001
1000000000000001001
1311111111111001001
1011000000000001011
1000000001000000001
1111111111111111111

